NO ./path_to_the_north_texture
SO ./path_to_the_south_texture
WE ./path_to_the_west_texture
EA ./path_to_the_east_texture

F 220,100,0
C 225,30,0

111111111111111111111111111111111
1000000000110000000000001
1011000001110000000000001
10010000000000000000000011111111
111111111011000001110000000000001
1000000000110000011101111101111111
111101111111110111000000100011111
11110111111111011101010010001
110000001101010111000000100001
10000000000000001100000010011
10000000000000001101010010N1
10000011101010111110111111111
11110111 1110101 101111010001
11111111011111000111111111111
11111111111111111111111111111