NO ./texture/north.xpm
SO ./texture/south.xpm
WE ./texture/west.xpm
EA ./texture/east.xpm

C 0,0,92

F 255,255,255



111111111111111111111111111111111
111110001100000000000111
11001000011100N0000000001
11001000000000000000000011111111
111111111011000001110000000000001
1000000000110000011101111101111111
111101111111110111000000100011111
11110111111111011101010010001
11000000110101011100000010001
10000000000000001100000010011
1000000000000000110101001011
10000011101010111110111111111
11110111 1110101 101111010001
11111111011111000111111111111
11111111111111111111111111111
