NO ./texture/north.xpm
SO ./texture/south.xpm
WE ./texture/west.xpm
EA ./texture/east.xpm
F 255,255,255
C 0,0,0



111111111111111111111111111111111
1000000000110000000000001
10110000W1110000000000001
10010000000000000000000011111111
111111111011000001110000000000001
1000000000110000011101111101111111
111101111111110111000000100011111
11110111111111011101010010001
11000000110101011100000010001
10000000000000001100000010011
1000000000000000110101001011
10000011101010111110111111111
11110111 1110101 101111010001
11111111011111000111111111111
11111111111111111111111111111
